NO textures/texture-01.xpm
SO textures/texture-02.xpm
WE textures/texture-03.xpm
EA textures/texture-04.xpm

C 91,166,252
F 224,184,144


11111111N111111